be putting on=입고 있는 중이다>
be hanging=걸고 있는 중이다>
have something on=입고 있는 중이다>
wear=입다; 상태>
get in=타다>
get off=내리다>
be ready to _=V(동사)>
be ready for _=N(명사)>
next to와 같은 표현 (2가지)=by, beside>
play instruments=악기를 연주하다>
spectators=구경꾼들>
lean _=on/against>
in a line=줄 지어진 걸 표현>
railing=난간>
rail=철길>
inside와 같은 표현 (1가지)=indoors>
outside와 같은 표현(1가지)=outdoors>
sign=표지판>
point at=(손가락으로) 가리키다>
reach for=(뭔갈 잡으러 손을) 뻗다>
take/conduct a tour=둘러보다>
laboratory 발음=르브라토리>
reading material=읽을거리>
workbench=작업대>
boardroom=회의실/큰 방>
make a photocopy=복사하다>
greet=환영하다>
1형식 단어 (7개)=go, come, arrive, rise, expire, work, merge>
2형식 단어 (10개)=be, become, stay, remain, look, seem, smell, taste, sound, feel, 얼굴 동사는 + like N>
4형식 단어 (6개)=give, send, forward(전달하다), offer, ask, teach>
5형식 단어 (6개)=keep, find, consider, make, call, expect>
enjoy + (toV/Ving/RV)=Ving>
annex=합병하다>
catering=음식 공급>
staffing=직원 채용>
customize=주인이 원하는 대로 만들다>
invest A _ B=in>
specialize=전문으로 하다>
specialize _=in>
'look forward'는 찾은/는 _을/를 뜻한다=과정>
'find'는 찾은/는 _을/를 뜻한다=결과>
직원을 뜻하는 단어 5가지=representatives, employees, staff, staff members, associates>
employment=고용>
confirmation=확인>
dietary=음식물의, 식이요법의